.....................................P....................................
.##########.######.######.##########..##########.######.######.##########.
.##########....#.....#....##########..##########....#.....#....##########.
............##...###...##........................##...###...##............
.##########....#.....#....##########..##########....#.....#....##########.
.##########....#.....#....##########..##########....#.....#....##########.
............##...###...##........................##...###...##............
.##########....#.....#....##########..##########....#.....#....##########.
.##########.######.######.##########..##########.######.######.##########.
..........................................................................
..........................................................................
.##########.######.######.##########..##########.######.######.##########.
.##########....#.....#....##########..##########....#.....#....##########.
............##...###...##........................##...###...##............
.##########....#.....#....##########..##########....#.....#....##########.
.##########....#.....#....##########..##########....#.....#....##########.
............##...###...##........................##...###...##............
.##########....#.....#....##########..##########....#.....#....##########.
.##########.######.######.##########..##########.######.######.##########.
..........................................................................
..........................................................................
.##########.######.######.##########..##########.######.######.##########.
.##########....#.....#....##########..##########....#.....#....##########.
............##...###...##........................##...###...##............
.##########....#.....#....##########..##########....#.....#....##########.
.##########....#.....#....##########..##########....#.....#....##########.
............##...###...##........................##...###...##............
.##########....#.....#....##########..##########....#.....#....##########.
.##########.######.######.##########..##########.######.######.##########.
..........................................................................
..........................................................................
.##########.######.######.##########..##########.######.######.##########.
.##########....#.....#....##########..##########....#.....#....##########.
............##...###...##........................##...###...##............
.##########....#.....#....##########..##########....#.....#....##########.
.##########....#.....#....##########..##########....#.....#....##########.
............##...###...##........................##...###...##............
.##########....#.....#....##########..##########....#.....#....##########.
.##########.######.######.##########..##########.######.######.##########.
..........................................................................