..........##########..........
..........##########..........
..........##########..........
..........##########..........
..........##########..........
..........##########..........
..........##########..........
..........##########..........
..........##########..........
..............................
##########.###..###.##########
##########...#..#...##########
##########...#..#...##########
##########.##.##.##.##########
##########.....P....##########
##########.##.##.##.##########
##########...#..#...##########
##########...#..#...##########
##########.###..###.##########
..............................
..........##########..........
..........##########..........
..........##########..........
..........##########..........
..........##########..........
..........##########..........
..........##########..........
..........##########..........
..........##########..........